00000000000000000!
00000000000000000!
00000000111110000!
00000000100010000!
11100000100010000!
00100000100010000!
00100000100011100!
00111100100000111!
00000111100000000!
00000000000000000!