000000000000000000000000!
000000000000000000000000!
000000000000000000000000!
000000000001111111110000!
000000000001000000010000!
000000000001000000010000!
111111000001000000010000!
000001000001000000011111!
000001000001000000000000!
000001111111000000000000!
000000000000000000000000!
000000000000000000000000!
000000000000000000000000!