000000000000000!
000000000000000!
000000001111100!
000000001000100!
111000001000100!
001000001000100!
001000001000111!
001111001000001!
000001111000000!
000000000000000!