0000000000000000000!
0000000000000001111!
0000000011111001000!
0000000010001001000!
1110000010001001000!
0010000010001001000!
0010000010001111000!
0011110010000000000!
0000011110000000000!
0000000000000000000!